5 20 20
  *  *#      *  **# 
# #   * #*   **   **
*#*  * # **  #1 *   
*##       #* #**   *
    *  *# #**      *
     ## #* ** * #** 
*  #   *#*  #*   ** 
**  p #    *  # 2 * 
* *   #  *  ** * #*1
 *  * #*    *#    **
      2   *   # *# *
**  # #**   2    #*#
*  * *  *   *   #   
 **        * **  *  
   #      #  # * ***
*#**    #           
 #  *  * ** *# # #* 
#  *#*  * *   *   **
  *   *  **         
 * **    *   *     *
