20 20 20
 * #  # **  *   #  *
* ##   * *  # #    *
* * 1*1# # *    * *#
 #    1  *   #  *#**
* *     2  #*2*  *2*
  *    # ##  #    * 
**  ##* #   *  * 1 *
  * * ***#    * * *#
   *  *   ##*  * p*#
# ****   *      **  
*1   *  #*##  #   *#
** ** ##  ##*    ***
  *#   * **1*#*#*#**
** ****** ** *  # * 
  * *#  *11*#  **  *
#  #* # #** *#  *  *
**#*** ##2* *   *#*2
   # #      *#      
#    #  #  #**  * * 
* *#**   *       * *
