3 20 20
#    *   * *  p**#* 
 * ###    * #      *
* *      ##  ** # # 
    * * **  #       
*#   #     ** *  *  
 # *  *##       #   
 *    *  **     *** 
   *    **       #  
*  #    ***     ** *
* #  *2    *    *   
  **   * **#    **  
 *#*     #*  **#**# 
#    ** * ** * **** 
  # ** *  **  * *  *
*#  **  ***#**#  *# 
        * *#**   # *
 #   #   *  *  2   *
* *             #   
*  1   #* * #* #    
   #**##1        * #
