22 20 20
#* * * #2  *#*##** #
1     1*# *  ** #***
        #  *  * #* *
  # *    2     *  # 
*#** *  ###*  *    #
* *   ##   ##**    #
* * *  *   *  ***   
*#  * *   #   **  #*
*     #  **  ** #1*#
**      * #1*     # 
    ***2*#* #  # #* 
*  *  1* * #**##**  
#  *   * #*p *###   
  * *   # *    ** **
#  #**   **# * *    
 #   **2*21  1 ** * 
 **  *  # *##  *  **
*#   #*  ** ***##* *
 ***    *#***#* ##1 
* * * ##*  # 1** # *
