13 20 20
* * **  #* *  *    *
   *##   *   *#*   *
**       *    * * #*
* #1# * #  * *# *   
*##   * #*   **  * *
  *# **   ** #*     
*   #*    ** # ##   
*   * *#   *   * *  
  # *# 2*  #    * * 
      *#  *1* *  ***
* * #     2 *** 1*  
 *#* * *   * * # *##
* *  #*  #   #**## #
 #2  2 * #* 1#*  *  
 ** *   #    *#  ** 
    #****## *       
 # # * *#**  *#* #  
 # *  *2 *#* *     *
#*     #   *#     **
** p *   * **    #  
