4 20 20
##*   * *  #  * **# 
#        #**   **1  
 * ** # * #  2 * *  
    * # ###  *    * 
* *    * * *    # * 
** * *#     *#*     
 # #   *         #* 
 *  ***** * #   * * 
 #  * #  *   #*     
* # # # * *       * 
   *  * * * # #  p  
#**  * *#**#   *  **
   **#* * * # * *#  
 * #* *  *  *    * *
         *      *  #
* *     *        *  
 2      *#1 * *#  *1
  *# * #* *  #*     
 **   #  #* # *  *  
 ***     * * * #* * 
