2 20 20
 *  *#* ***    * *  
* ##    *   *#      
#  * *  * * # #  *  
# *     #*#*        
    *   # **   * # *
     *   *    #*  # 
   *# 2**     *    *
   *p      *#  #**  
*  *        **     *
    *    * *     *  
*1 # *# #  2##  *   
     *  #  *  **#* *
  **** #  **# *   *#
*  * #  1       *** 
*   ***    #     #* 
## ** *# * * * **  *
## *  *   # * #  #* 
**#*  **         *  
 *  * *#*   #   #   
     **  * *   ** * 
