28 20 20
*      #**#* 1*#** #
#*2*  *  ##* #  # * 
    ***2*## **##   *
**   * #1 **##  *  *
*  **  #* ***    ** 
*#*# ##    *# * *  *
# ****** **1 # * ## 
#* *   *2  * ***#* *
    **#1**#   *  *  
  *## #*#* #*   # * 
   *#*##     ** *1 *
 *#*#1 * *## ** **  
   #  #*#   ***#*#  
  ** #**  #**  ##*  
      #       #* ** 
*2* **  *11* *  * **
    2   * *  #    * 
#1  # #*##   1**** *
  ##2# #* *p #  *   
 * *  * 1#**  *## * 
