22 20 20
#        * #** #*   
 ***2  *    # 1*  #*
* **#     *  11#    
 *1** *   #*1## #* *
##    *     ##     #
 ##*   * # 2*#*#*** 
*  p # # * **#   * *
 ** #****# *  *#1* #
    #  ***  ** 1    
 #* **   #  * ***#* 
  ** *  #  * ****   
*#      #  *   *    
 #*  # #* #*  *   # 
* * *          *** #
****##  * *#**#**   
*   #*#  *# 11*# **#
 #  *  *2# #    *  *
*#***## 2*   ***  **
  *  * # #  * ** *# 
 #* #*2 * * * ***#  
