27 20 20
2# 1##* *** *#  *  *
***  *  ##* ###  ## 
     *         * # #
1 ** p   ** #*#* *##
* *** * #  * * **  *
   #***   # # *1** #
 *# *#* *#    #* #**
#*  *1** *#**   # ##
**## * **    * **   
***  2   *   #*   * 
 *#* #*** ** #** * *
  #2 **##*** *   #  
   * #* * #*# #  ***
 **   *  *   * *##  
1*  *  ##1#*# #     
1     *#  ** * ***#*
2 # *2 *# *# 1  **  
  #** * ##*#2 ** *  
 #   #*2   *   *  **
#  #*   #   * 2 *  *
