16 20 20
     #*    *  #  * 2
1#* #     * #*    * 
** #  # 1 #* #** # *
**  *  *     * *1#  
   * #*      #      
  #  *** 1  p  *#* *
*   *** #*  #  * *  
# ** **22# **  1*  #
 *  ** # ** #*** *  
* * * *  #   ##    #
*      *  *#**# *** 
   #* #* *  # #     
*1 *#*# # ###  *   #
   * 1#  #*      ** 
#   ##       #**  * 
## *  * * ****   ** 
 *  * ** #*   * #  *
**  # *  * * # *  **
2*  * *  * ** ** #  
 **# ***#* # **   # 
