24 20 20
* # * ***##*1#  *  #
   *    **   *#  #  
   *** *    **##*** 
##   #*1# 2*  *#**# 
*#   ***#21   #* *  
  #   *#2     *   **
 **2**** # * 1 # * #
*  *  ##    * # *   
#    * * * *    ** *
  # *1     #  *# * *
*#  #* ***  * 2  #* 
 ** *1**   * * *  **
#  *#***** *    * * 
  #*1*#     p*   ** 
  ** ## #*#**** * *1
##    # #  *  # **# 
     * ###** # **#  
* #  **     ##  *## 
 *   *# * * * *1##* 
* #**   * *#  #* *1#
