18 20 20
 ## 1 *  #   1   *# 
# * *   *#  #*  *#  
** *   *  *  ** ##*#
  *  *1 ** #*  *    
#1  * * *** *#** *2*
   * #* * #     ** *
  #*1*  2# #  #**  *
    * **#  ** *  #**
#    *#*   *   #*  #
**** * *   22# * ** 
  **1* **    ** *** 
  *1 ## **      p*  
 # * #*  # *       *
* *    **#* *#**   #
##* *# # *  *     *#
#*#*   # *1      #  
 *## # #*#*  #*   #*
 *#   ##***         
   # #  ****      * 
    * **  ## ** **  
