p   ##  ##*       *
  ** *** * *
    *###   *
   1 * #  2*** *  *#
    *# * * * #*   *#
*#   * **  #    #* *
 # *   **  *   #
  * ** * # *  ##* #
        # ***    * *
# *** * *   ***  ##
 **  *  *  * *   **
 *    #   *      #
 * *    * *  *# ***
*#   #*# **##### *
  **#        *# * #
 * # * * #       * *
* # * #** *     *
   #  *    #  #  * #
 * *         * * * *
*          ## **   #