2 20 20
  ***     *         
 ## *     *   ***#* 
* * **  #  *## #* * 
 #* # **    *   * * 
       **  # * *    
*   1  #        *#  
* * ** *#  p  *#  # 
     * **    * **** 
**  *#**#      # #*1
#2      *# #  *    #
  *  ****       **  
 ***   ## *    * #  
*       *  *      *#
*** ##      *#      
 * * #*** **        
 **** *   *  * * ** 
###  *#    #*      *
  #  *   **  #  #   
* # *#*    **#  #   
 #**    *#     ** **
