8 20 20
1   #*  #    #*   **
** ## * * * **   * *
   ** #   #  *#  *  
***#**  *** #  *** *
   #*     *       **
 **  # * *   * *  * 
  *#* **  #2   #    
*# *  *   * *#  # # 
* * #  *#*#  *     *
# *#     *# #* **  #
   *#1*   **# * #   
* *     *    **  #  
 * #   *  ## # *  *#
      p      *2 * * 
 # #1* # ** * #   * 
  *     #   ** **1 *
  *  #  # #*      * 
 * *    * *  # **#**
  * ##   * *  2*    
**     *  *      *  
