2 20 20
**     # *#      ** 
 **     *     **# * 
  *#    *     **  * 
# *  *#   * *  * #**
 *  * #**   1*      
#   *  #     *   *  
 *   * ** *   #* #  
  # **          ##  
*  **  * ##*      # 
 *** **  *      * **
* * 1     *   *   1*
 * *    *     *  * *
 * *##  #*  *  ##   
   * *#    *   **  #
   # ** ***2      #*
 #   # *    #    *# 
 * *#*  *    *# #  *
 #     *  *  * # #  
 # **       #  #p **
* * * **** *#   #   
