18 20 20
 *  2          #**  
 #*    #* *# ** ****
* * * *** #  *   ** 
# #*##*    1# #*  # 
** ** p#  #  * *# #*
   11* *   *  *  *  
 * #      * #  ** * 
*#* ## #    #***  **
#*         2#  1 ** 
*****# *   * * ** # 
#   *1#     **** *  
 *#2 * #* ****#* *  
 *   #* * *  **    #
 * *  * #   # #     
*  # *# ***# **     
1 *  **  # #  *  *  
#     1* **# *#   #*
  #   2   # * #***##
** #    *# 1 # #    
 ## * *****#* *    *
