5 20 20
    *    * # * * *  
 # # *   * **  #    
   * *  1     # # * 
 # *           #*   
 ###    #     #  2* 
*  *  **  #2  *  #* 
 ***  ***#  #       
     #   * *     ***
* *    *  * # * # * 
 #**    *#p *  2*** 
 *      *    # *   *
 *     #    *  *  **
     *   *#   *  #  
*#  **#*      ** #**
   *### *  ** *  *  
******# * * * #   #*
 *# # *#*# *   * * #
 *  *  1 *     **** 
      #  #**      **
*#*   **# * # * *   
