6 20 20
      * #* * **     
*# *# #  **   * # * 
#* * *   2  *  #  * 
** *#            * #
*  * #  **   ** **# 
   *  1#   p   **   
   * * *  #    2 # #
     ** * *      * *
*  *    *#          
**  *#  * 1* * * ** 
*#* #  * **#***     
     *     *  #   **
    *       *     * 
# #  #     #   * *  
* #*  **   **  *    
#* 1#   * #   #**   
# *# ** ##   *  *## 
**    #   # ##* *   
* 1 *#  *  *# #**** 
*  *#  #**  #*** * *
