29 20 20
   2*   ***# *#**** 
# *  * #*# *#**##  *
   # * ** * #***    
#*##* #1*#2*# # #*# 
 1*### *  * **    **
1     #  * ##*   ##*
**##*     *#  # *   
  p#  # * *   * 2#* 
#    *     *#  ** ##
1  * *    *** ***2  
* *    #*#**  * * * 
** *1* **  * *  *** 
   *  **  *  #* ##**
* #  #  * #*** **** 
 # *##  *** **# # 2*
# * 21#  #*  *  *   
  2**2###* *#*# ****
#*   21 #    1**   #
 * ##** *  # * * # #
  *     #**  #  *** 
