23 20 20
 #*    *##   *  * 1*
*2# #    * ** #* ** 
 #*   * *   *       
  ** ##   #** **1*#*
**    ***# *  1 #**#
*  * #      p  *  22
** *   #* * #  **  1
    1#**# # ***   *#
**   2      2   ****
*  **# ** ##* * *** 
* *  * *#** *#  # # 
#* #****#*  *#*#  #*
* #* #*2   ###*  #*#
 #*   *#* #*  *  * *
    *       #  *##  
    * *# *#* *   2**
 *      #* #1*#* *##
 **  #   *    ** *  
*  #** #*#*     *   
# * #**   #* #*  1# 
