25 20 20
 1 *  *#    **# ##**
* #*  *  *#  * * *  
***** * * * *  * ** 
  2 **# # ******* # 
 ###*   * * *## #*#*
   ##* * **  ** #1##
      *#    #* * *#*
   2 *  *# *# *#*#  
* #  *#*1  #*2#    *
#*  #2*  ###*# * p# 
*      **  #   #  * 
***  * *#*# *# *    
 #*   ##** #* * #*  
* *** *    **2 * #  
#*  1 1#   *  *     
  *     *  *** # ** 
##*** *#  **2  1#2 #
  #  *  #*2 *    #  
*   **1*   #   *****
* * #    ***#  # *  
