3 20 20
 * *       *     *  
   **  * *  #   **  
# **   *#  *  *   **
#   **  *  #*  **  *
*# **# #* *   **  * 
   *#  *  * *2*#    
        ## #* #*# # 
*   *  *   * #      
***## #    *#*  # * 
  2#*  ##    **   # 
 *#      #     #* * 
    *   ** *#   ****
#  ****   *  *# 1** 
    ****1##        *
      **  # * p *#* 
  #   * *         # 
 *     #* **   *    
*   *  *  *        #
 * *  *  * *#    *  
*    #    *#* **    
