12 20 20
*    # *#           
 *    **** * * *  * 
 * *#* *     ## **  
*  # *  **  *#**1   
# **  **   **  * **#
 ## ***** *   *    #
  **#1#  #1*       *
#** 1* * # * *      
 #   *   ##*   ***  
     *# *   #   #   
* *#     ***#*  * #*
  *#  *    * *  ##  
  * # **       *   #
 * *  *#    **# *# #
*2**   *  #       **
# *# #*2* *      *p 
** *   * #*21*      
  #  ##     *#* ****
*      ####* * 1# * 
 # *   ** *# #  **  
