1 20 20
  #     *  #*      #
** * **   **        
## * *      * *# *  
** **#  * *       * 
 *# *#*  *  *    #**
         #** # ##*# 
  ** #   ** 2     **
  # * # **# *#  * **
 **   *    *#* **   
   ##*       #   #  
    * *   *   *  *  
   *    *  #*  # * *
    *  *    # * *   
    *   #*  ***     
* #  * 1*    * 2 *  
#p *    ***#*    #**
  *#*     * *# *    
# # * *   **      **
  *   **       *  # 
        *  ###   * *
