21 20 20
#*   *#  #   *# 2  #
 21* **#1  2 *#  * #
* * *1   ## *#* 1  *
 ##   **  *  **   **
   **# # ** * *  *  
 ***   # *  *  * *##
****    **    *   # 
* #       2    * *  
  **#1 * * #*   **  
 # 2    **#* *** * *
 *  # ** ##*   ****#
 #** **#  #* * #*  *
* *#* *  p# *   *  #
 #**     # * #   * #
* #  # # # ****  ## 
* #** * **   #* *   
 ** *  *  2##*    # 
# *    *  #**##  *  
#*#*  ## * 2**   *  
***##   #    1*   **
