10 20 20
*  1  *#      *#* * 
  # * *# * ##    *# 
#    ***  #        *
*   **  * ##   *   *
   **  *    * *#* 2 
  1#    **  *   * # 
     *  #*  #*      
#    * #*   ** 1 ** 
* *          #    * 
*#* #  #*   * #   *#
*  ##* # *#     #*# 
 * *    * **  *  ***
*  ***  #  #**    1 
#**  *  *# # 12*#*#*
** *#  **      *   *
* ** * **#   **#  #*
#      * ##   *  **#
 * ****#  *#   *# * 
* ***  #*          *
    *p *  2*  *   # 
