100 20 20
  # * 1*  *  2 **#  
*#   #**** *## ** #*
#* #    *#* #*    1*
  *   * #***  ** *1*
#*1 # #2  * ##**  **
**#   *  ***##** # *
* 1** ##** *1  *#** 
* 1* *** *#* 11**##*
** * 1 * 1* *   * *#
** #*  *  **2**   # 
 *1  *** *  # 1 # *#
1*# # ##* ##  *#* # 
2     **1 * #**1 1# 
**  # *##   **# ***2
2***#**1  * #* * #* 
**# *#  *##**  *# #*
**  **    *2*1#* # #
* p #* **1***#*#2 * 
** #* **2 #*# ** #*#
# *# * * #2*   **  *
