9 20 20
*  *  **  *   * *# *
    *  #    *# #* # 
   **    * *  **    
 *# *#* #   *  **   
 **  *  #*  *   * * 
   *   # #*   *     
  *  *   *     #   #
   *  *#*  *  ##  # 
        * 1*** *  * 
  **  #**  ## ##  ##
*#    #  * ****  1# 
** 1   *   #  * * * 
          # 2* ***# 
* 22* *  #**    * *#
*#*   * # * *  *  * 
  #*** * *    * *## 
*  *#*** *     #* ##
*   #*2 * #*p  #  * 
      ###*      *   
  * **     *# ***# *
